occipital	cap	4	patrat
ochiului	cap	4	orbicular
levator_labii	cap	2	fusiform
rizorius	cap	2	fusiform
rlatisma	cap	4	orbicular
procerus	cap	2	fusiform
conrugator	cap	1	romboid
mestecator	cap	4	patrat
miohioid	cap	4	patrat
nazal	cap	1	patrat
zigomatic_mic	cap	2	fusiform
buccinator	cap	1	romboid
zigomatic_mare	cap	2	fusiform
orbicular_al_gurii	cap	2	orbicular
mentonier	cap	1	patrat
levator_labii	cap	1	fusiform
procerus	cap	1	patrat
masseter	cap	2	romboid
silohilodian	cap	1	fusiform
digrastic	cap	2	fusiform
splenisul_capului	cap	4	patrat
sternohyod	cap	1	romboid
ridicator_scapuluei	cap	2	fusiform
scalen_anterior	cap	2	fusiform
scalen_mijlociu	cap	2	fusiform
scalen_posterior	cap	2	fusiform
tiroid	cap	2	romboid
costricor_faringian	cap	1	romboid
omohiodian	cap	2	fusiform
sterohiodian	cap	2	fusiform
mastoidian	cap	2	fusiform
iliopsoas	picior	1	romboid
tensor_latae	picior	2	romboid
sartorius	picior	2	fusiform
vastus_lateral	picior	2	fusiform
iliotibal_tract	picior	2	fusiform
peroneus_lung	picior	2	fusiform
tibial_anterior	picior	2	fusiform
digitorum_entensor	picior	2	fusiform
peroneus_brevis	picior	2	fusiform
hallucis_extensor	picior	2	fusiform
reticul_extensor	picior	1	patrat
soleus	picior	2	fusiform
gastrocnemius	picior	2	fusiform
vastus_mediu	picior	1	romboid
rectus_femoris	picior	2	romboid
adductor_lung	picior	1	romboid
gracilis	picior	1	fusiform
penictineus	picior	1	triunghiular
adductor_magnus	picior	1	romboid
semimembranosus	picior	2	fusiform
sartoris	picior	1	romboid
plantaris	picior	2	fusiform
malleolus_mediu	picior	1	romboid
flexor_digirorum	picior	2	fusiform
flexor_hallucis	picior	1	romboid
soleus	picior	2	fusiform
biceps_femoris	picior	2	romboid
glureus_mediu	picior	1	triunghiular
pectoralis_major	brat	2	triunghiular
coracobranchialis	brat	1	triunghiular
biceps	brat	2	fusiform
branchialis	brat	2	romboid
branchioradialis	brat	2	fusiform
flexor_carpi	brat	2	fusiform
thenar	brat	1	patrat
hyponthenar	brat	1	romboid
flexor_carpi	brat	2	fusiform
palmaris_lung	brat	2	fusiform
pronotor_teres	brat	2	patrat
teres_minor	brat	2	romboid
teres_major	brat	2	romboid
triceps	brat	2	romboid
extensor_carpi	brat	2	romboid
extensor_digitorum	brat	2	fusiform
extensor_ulnaris	brat	2	fusiform
gluteus_maximus	picior	2	romboid
latissimus_dorsi	trunchi	2	fusiform
serratus_anterior	trunchi	1	romboid
rectus_abdominis	trunchi	2	patrat
oblic_abdominal	trunchi	1	patrat
trapez	trunchi	3	romboid
detloid	trunchi	1	romboid
infraspinatus	trunchi	1	triunghiular
teres_minor	trunchi	1	triunghiular
teres_major	trunchi	1	romboid
fascia	trunchi	1	romboid
intern_abdominal	trunchi	1	fusiform
extern_abdominal	trunchi	1	fusiform
erector_spinae	trunchi	2	fusiform
serratus_inferior	trunchi	2	fusiform
rhomboideus_major	trunchi	1	fusiform
serratus_superior	trunchi	1	patrat
supraspinatus	trunchi	1	romboid
rhomboideus_minor	trunchi	1	fusiform
levator_scapule	trunchi	1	romboid
splenius_cervicis	trunchi	1	romboid
splenuis_capitis	trunchi	1	romboid
semispinalis	trunchi	1	triunghiular
miocard	inima	1	romboid