nerv_accesor	cap	5	forma_de_L
nervi_supraclaviculari	trunchi	4	orbicular
nervul_lui_Arnold	cap	5	fusiform
nerv_anococcigian	trunchi	5	fusiform
ansa_cervicala	cap	5	orbicular
nerv_interosos_anterior	membre	5	fusiform
nerv_superior_alveolar	cap	2	forma_de_s
plex_aortic	trunchi	5	forma_de_L
plexul_lui_Auerbach	trunchi	3	forma_de_L
nerv_auriculotemporal	cap	5	forma_de_L
nerv_axilar	membre	6	fusiform
plex_brahial	trunchi	6	forma_de_s
ramura_bucala_faciala	cap	5	fusiform
nerv_bucal	cap	4	orbicular
plex_cardiac	trunchi	4	forma_de_L
plex_cavernos	cap	6	fusiform
celiaca_ganglionilor	trunchi	7	forma_de_L
ramura_cervicala_faciala	cap	9	forma_de_s
plex_cervical	cap	7	fusiform
cord_timpanic	cap	9	fusiform
ganglion_ciliar	cap	5	forma_de_L
nerv_coccigian	trunchi	9	forma_de_s
nerv_cohlear	cap	10	fusiform
nerv_fibular_comun	membre	4	fusiform
nerv_digital_palmear	membre	3	fusiform
ramura_nervului_radial	membre	8	fusiform
nerv_fibular_profund	membre	10	forma_de_s
nerv_petros	cap	3	forma_de_s
nerv_temporal	cap	12	fusiform
banda_diagonala	cap	11	fusiform
ramura_digastrica	cap	9	fusiform
ramura_dorsala	membre	10	fusiform
nerv_dorsal_al_clitorisului	trunchi	11	forma_de_s
nerv_dorsal_al_penisului	trunchi	7	forma_de_L
nerv_dorsal_scapular	trunchi	7	forma_de_L
plex_esofagial	trunchi	9	forma_de_s
nervi_etmoidali	cap	11	forma_de_s
nerv_extern_al_laringelui	cap	6	liniar
nerv_extern_al_nasului	cap	9	liniar
nerv_facial	cap	8	forma_de_s
nerv_femural	membre	3	forma_de_s
nerv_frontal	cap	3	fusiform
plexuri_gastrice	trunchi	6	fusiform
ganglion_gengiculat	cap	4	fusiform
ramura_genitala	trunchi	7	fusiform
nerv_genitofemural	trunchi	5	fusiform
nerv_glosofaringian	cap	3	forma_de_L
nerv_mare_auricular	cap	5	forma_de_s
nerv_mare_occipital	trunchi	10	fusiform
nerv_mare_petros	cap	5	forma_de_s
plex_hepatic	trunchi	7	forma_de_s
nerv_hipoglosal	cap	11	forma_de_s
nerv_iliohipogastric	trunchi	12	liniar
nerv_ilioinghinal	trunchi	11	forma_de_s
nerv_alveolar_inferior	cap	8	forma_de_s
nervi_anali_inferiori	trunchi	8	fusiform
nerv_caridac_inferior	trunchi	3	fusiform
ganglion_cervical_inferior	cap	7	fusiform
nerv_fesier_inferior	membre	4	fusiform
plex_hipogastric_inferior	trunchi	7	fusiform
plex_mezenteric_inferior	trunchi	8	fusiform
nerv_palpebral_inferior	cap	3	fusiform
nerv_infraorbital	cap	7	fusiform
plex_infraorbital	cap	6	forma_de_L
nerv_infratrochlear	cap	12	fusiform
nervi_intercostali	trunchi	9	fusiform
nerv_intercostobrahial	membre	5	forma_de_s
nerv_cutant_intermediar	membre	10	forma_de_s
plex_carotid_intern	cap	6	forma_de_s
nerv_laringian_intern	cap	6	fusiform
interneuron	cap	10	liniar
ganglion_jugular	trunchi	7	forma_de_s
nerv_lacrimal	cap	3	fusiform
cord_lateral	trunchi	9	forma_de_s
nerv_cutant_antebrat	membre	4	fusiform
nerv_cutant_coapsa	membre	8	forma_de_s
nerv_pectoral_lateral	membre	11	fusiform
nerv_plantar_lateral	membre	7	forma_de_s
nerv_pterigoid_lateral	cap	11	fusiform
nerv_occipital_mic	cap	4	forma_de_s
nerv_lingual	cap	8	liniar
nervi_ciliari_lungi	cap	5	liniar
radacina_ganglionului_ciliar	cap	9	liniar
nerv_toracic_lung	membre	5	fusiform
nerv_subscapular_inferior	trunchi	6	forma_de_s
nervi_lombari	trunchi	4	fusiform
plexuri_lombare	trunchi	10	fusiform
nervi_splanhnici_lombari	trunchi	4	forma_de_L
nerv_lumboinguinal	membre	9	forma_de_s
plexuri_lumbosacrale	trunchi	7	fusiform
trunchi_lumbosacral	trunchi	9	fusiform
nerv_mandibular	cap	6	forma_de_L
ramura_marginala	cap	7	forma_de_s
nerv_maseteric	cap	4	forma_de_s
nerv_maxilar	cap	6	forma_de_s
cordon_medial	trunchi	4	forma_de_s
nerv_cutant_brat	membre	11	fusiform
nerv_cutanat_antebrat	membre	6	fusiform
nerv_cutant_medial	membre	10	forma_de_s
nerv_medial_pectoral	membre	11	forma_de_s
nerv_plantar_medial	membre	4	forma_de_L
nerv_pterigoid_medial	cap	9	orbicular
nerv_median	membre	6	fusiform
plexul_lui_Meissner	trunchi	6	fusiform
nerv_mental	cap	5	orbicular
nerv_cardiac_mijlociu	trunchi	7	fusiform
ganglion_cervical_mijlociu	trunchi	11	forma_de_s
nerv_meningial_mijlociu	cap	4	forma_de_L
nerv_motor	trunchi	7	forma_de_L
ramurile_nervului_radial	membre	7	forma_de_L
nerv_musculocutanat	membre	4	fusiform
nerv_mylohyoid	cap	8	forma_de_s
nerv_nasociliar	cap	8	fusiform
nerv_nasopalatin	cap	4	orbicular
nervul_canalului_pterigoid	cap	4	forma_de_L
nerv_obturator_internus	membre	9	fusiform
nerv_quadratus_femoris	trunchi	4	forma_de_L
nerv_piriformis	trunchi	10	forma_de_s
nerv_stapedius	cap	6	fusiform
nerv_subclavius	trunchi	7	fusiform
nervus_intermedius	cap	7	forma_de_L
nervus_spinosus	cap	3	forma_de_s
ganglion_nodos	cap	8	fusiform
nerv_obturator	membre	10	fusiform
nerv_oculomotor	cap	7	fusiform
nerv_olfactiv	cap	9	fusiform
nerv_oftalmic	cap	9	forma_de_s
nerv_optic	cap	3	forma_de_s
ganglion_otic	cap	5	fusiform
plex_ovarian	trunchi	3	fusiform
nervi_palatini	cap	7	fusiform
ramura_nervului_median	membre	7	fusiform
ramura_nervului_ulnar	membre	7	forma_de_s
plex_pancreatic	trunchi	3	forma_de_L
plex_patelar	membre	5	forma_de_L
nervi_pelvieni	trunchi	6	forma_de_s
nerv_perforator_cutant	membre	7	forma_de_s
ramuri_posterioare	membre	9	liniar
nerv_perineu	trunchi	4	liniar
ganglion_petros	cap	12	forma_de_s
ramura_nervului_vag	cap	8	forma_de_s
ramurile_glosofaringian	cap	7	fusiform
nerv_faringian	cap	7	fusiform
plex_faringian	cap	6	fusiform
nerv_frenic	cap	10	fusiform
plex_frenic	cap	11	fusiform
nerv_posterior_auricular	cap	5	forma_de_L
ramura_nervului_spinal	trunchi	3	forma_de_s
cordon_posterior	trunchi	6	fusiform
nerv_cutanat_al_bratului	membre	12	forma_de_s
nerv_cutant_al_antebratului	membre	11	forma_de_s
nerv_cutant_al_coapsei	membre	11	forma_de_s
nervi_scrotali_posteriori	trunchi	6	liniar
nerv_posterior_inferior	cap	6	forma_de_s
nervi_palmari_digitali_proprii	membre	10	forma_de_s
plex_rostatic	trunchi	5	fusiform
ganglion_ptericogalatin	cap	5	fusiform
nerv_pudendal	trunchi	6	fusiform
plex_pudendal	trunchi	4	fusiform
ramurile_nervului_vag	cap	8	fusiform
nerv_radial	membre	9	fusiform
nerv_laringian_recurent	cap	6	fusiform
plex_renal	trunchi	4	fusiform
plex_sacral	trunchi	10	forma_de_L
nervi_sacrali	trunchi	5	fusiform
nerv_safen	membre	10	fusiform
nerv_sciatic	trunchi	10	forma_de_s
ganglion_semilunar	cap	10	forma_de_s
nerv_senzorial	cap	10	forma_de_s
nervi_ciliari_scurti	cap	6	fusiform
nervi_sfenopalatini	cap	4	liniar
plex_splenic	trunchi	6	forma_de_s
nerv_subcostal	cap	6	fusiform
ganglion_submandibular	trunchi	7	forma_de_s
nerv_suboccipital	cap	10	fusiform
ramura_nervului_radial	trunchi	10	forma_de_s
nerv_fibular_superficial	membre	5	fusiform
nerv_cardiac_superior	membre	8	forma_de_s
ganglion_cervical_superior	trunchi	3	fusiform
ganglion_superior	cap	11	forma_de_s
nerv_gluteal_superior	cap	4	liniar
plex_hipogastric_superior	membre	7	liniar
nerv_labial_superior	trunchi	8	liniar
nerv_laringial_superior	cap	8	fusiform
nerv_cutant_al_bratului	cap	3	forma_de_s
plex_mezenteric_superior	membre	11	fusiform
plex_rectal_superior	trunchi	5	fusiform
nervi_supraclaviculari	trunchi	9	forma_de_L
nerv_supraorbital	cap	5	forma_de_s
nerv_suprascapular	cap	4	fusiform
plex_suprarenal	trunchi	11	fusiform
nerv_supratrohlear	trunchi	10	forma_de_L
nerv_sural	cap	11	forma_de_s
trunchi_simpatic	membre	7	forma_de_s
nerv_al_treilea_occipital	cap	10	forma_de_s
nervi_toracici	cap	6	forma_de_s
nervi_toraco_abdominali	trunchi	6	fusiform
nerv_toracodorsal	trunchi	3	fusiform
nerv_tibial	trunchi	7	forma_de_s
nerv_cervical_transversal	trunchi	5	forma_de_s
nerv_trigemen	membre	8	fusiform
nerv_trohlear	cap	5	forma_de_s
nerv_timpanic	cap	9	liniar
nerv_ulnar	cap	11	liniar
nerv_subscapular_superior	cap	5	liniar
plex_uterovaginal	membre	5	fusiform
nerv_vag	trunchi	4	forma_de_s
ramus_ventral	trunchi	5	fusiform
plex_vezical_nervos	cap	3	fusiform
nerv_vestibular	trunchi	4	forma_de_L
nerv_vestibulocohlear	trunchi	3	forma_de_s
ramurile_nervului_facial	cap	4	fusiform
nerv_zigomatic	cap	7	fusiform
nerv_zigomaticofacial	cap	11	fusiform
nerv_zigomaticotemporal	cap	4	fusiform