os_frontal	cap	1	forma_neregulata
os_temporal	cap	2	forma_neregulata
os_parietal	cap	2	forma_neregulata
os_occipital	cap	1	forma_curbata
os_etmoid	cap	1	forma_neregulata
oase_suturale	cap	10	forma_neregulata
os_sfenoid	cap	1	forma_de_fluture
os_nazal	cap	2	forma_neregulata
os_lacrimal	cap	2	forma_neregulata
os_zigomatic	cap	2	forma_patrulatera
maxilar	cap	2	forma_neregulata
mandibula	cap	1	forma_neregulata
vomer	cap	1	forma_trapezoidala
cornetul_nazal_inferior	cap	2	forma_trapezoidala
os_palatin	cap	2	forma_de_L
ciocan	cap	2	forma_neregulata
nicovala	cap	2	forma_neregulata
scarita	cap	2	forma_neregulata
os_hioid	cap	1	forma_de_potcoava
C1	cap	1	forma_neregulata
C2	cap	1	forma_neregulata
C3	cap	1	forma_neregulata
C4	cap	1	forma_neregulata
C5	cap	1	forma_neregulata
C6	cap	1	forma_neregulata
C7	cap	1	forma_neregulata
T1	trunchi	1	forma_neregulata
T2	trunchi	1	forma_neregulata
T3	trunchi	1	forma_neregulata
T4	trunchi	1	forma_neregulata
T5	trunchi	1	forma_neregulata
T6	trunchi	1	forma_neregulata
T7	trunchi	1	forma_neregulata
T8	trunchi	1	forma_neregulata
T9	trunchi	1	forma_neregulata
T10	trunchi	1	forma_neregulata
T11	trunchi	1	forma_neregulata
T12	trunchi	1	forma_neregulata
L1	trunchi	1	forma_neregulata
L2	trunchi	1	forma_neregulata
L3	trunchi	1	forma_neregulata
L4	trunchi	1	forma_neregulata
L5	trunchi	1	forma_neregulata
os_sacral	trunchi	1	forma_triunghiulara
os_coccigian	trunchi	1	forma_neregulata
clavicula	trunchi	2	forma_neregulata
omoplat	trunchi	1	forma_triunghiulara
os_coxal	trunchi	2	forma_neregulata
ilium	trunchi	1	forma_neregulata
ischium	trunchi	1	forma_neregulata
pubis	trunchi	1	forma_neregulata
stern	trunchi	1	forma_de_T
coaste	trunchi	24	forma_curbata
humerus	membre	2	forma_dreapta
radius	membre	2	forma_curbata
ulna	membre	2	forma_dreapta
os_trapez	membre	2	forma_neregulata
os_trapezoid	membre	2	forma_neregulata
os_capitat	membre	2	forma_neregulata
os_cu_carlig	membre	2	forma_neregulata
os_pisiform	membre	2	forma_ovalara
os_piramidal	membre	2	forma_piramidala
os_semilunar	membre	2	forma_semilunara
os_scafoid	membre	2	forma_ovala
oase_metacarpiene	membre	10	forma_dreapta
falange_distale	membre	10	forma_neregulata
falange_intermediare	membre	8	forma_neregulata
falange_proximale	membre	10	forma_neregulata
femur	membre	2	forma_dreapta
rotula	membre	2	forma_rotunda
fibula	membre	2	forma_dreapta
tibie	membre	2	forma_dreapta
talus	membre	2	forma_neregulata
calcaneu	membre	2	forma_prismatica
navicular	membre	2	forma_neregulata
cuneiform_medial	membre	2	forma_neregulata
cuneiform_intermediar	membre	2	forma_neregulata
cuneiform_lateral	membre	2	forma_neregulata
cuboid	membre	2	forma_cubica
metatarsiene	membre	10	forma_dreapta
falange_distale	membre	5	forma_neregulata
falange_intermediare	membre	4	forma_neregulata
falange_proximale	membre	5	forma_neregulata
